अभिजिघ्रन्ती इत्यभि-जिघ्रन्ती	अभिजिघ्रन्ती इति अभि-जिघ्रन्ती,अभिजिघ्रन्ती,अभि-जिघ्रन्ती
आचरन्ती इत्या-चरन्ती	आचरन्ती इति आ-चरन्ती,आचरन्ती,आ-चरन्ती
आतुजी इत्या-तुजी	आतुजी इति आ-तुजी,आतुजी,आ-तुजी
आयजी इत्या-यजी	आयजी इति आ-यजी,आयजी,आ-यजी
इतऊती इतीतः-ऊती	इतऊती इति इतः-ऊती,इतऊती,इतः-ऊती
इरावती इतीरा-वती	इरावती इति इरा-वती,इरावती,इरा-वती
ऋतयिनी इत्यृत-यिनी	ऋतयिनी इति ऋत-यिनी,ऋतयिनी,ऋत-यिनी
ऋतवरी इत्यृत-वरी	ऋतवरी इति ऋत-वरी,ऋतवरी,ऋत-वरी
गोपती इति गो-पती	गोपती इति गो-पती,गोपती,गो-पती
घृतयोनी इति घृत-योनी	घृतयोनी इति घृत-योनी,घृतयोनी,घृत-योनी
घृतवती इति घृत-वती	घृतवती इति घृत-वती,घृतवती,घृत-वती
घृतासुती इति घृत-आसुती	घृतासुती इति घृत-आसुती,घृतासुती,घृत-आसुती
चित्रराती इति चित्र-राती	चित्रराती इति चित्र-राती,चित्रराती,चित्र-राती
तिग्महेती इति तिग्म-हेती	तिग्महेती इति तिग्म-हेती,तिग्महेती,तिग्म-हेती
दँपती इति दम्-पती	दंपती इति दम्-पती,दंपती,दम्-पती
दीद्यग्नी इति दीदि-अग्नी	दीद्यग्नी इति दीदि-अग्नी,दीद्यग्नी,दीदि-अग्नी
द्रवत्पाणी इति द्रवत्-पाणी	द्रवत्पाणी इति द्रवत्-पाणी,द्रवत्पाणी,द्रवत्-पाणी
धारयत्कवी इति धारयत्-कवी	धारयत्कवी इति धारयत्-कवी,धारयत्कवी,धारयत्-कवी
धारयत्क्षिती इति धारयत्-क्षिती	धारयत्क्षिती इति धारयत्-क्षिती,धारयत्क्षिती,धारयत्-क्षिती
धेनुमती इति धेनु-मती	धेनुमती इति धेनु-मती,धेनुमती,धेनु-मती
नृपती इति नृ-पती	नृपती इति नृ-पती,नृपती,नृ-पती
पथिरक्षी इति पथि-रक्षी	पथिरक्षी इति पथि-रक्षी,पथिरक्षी,पथि-रक्षी
पुरँधी इति पुरम्-धी	पुरंधी इति पुरम्-धी,पुरंधी,पुरम्-धी
पूर्वजावरी इति पूर्व-जावरी	पूर्वजावरी इति पूर्व-जावरी,पूर्वजावरी,पूर्व-जावरी
प्रभूती इति प्र-भूती	प्रभूती इति प्र-भूती,प्रभूती,प्र-भूती
मदपती इति मद-पती	मदपती इति मद-पती,मदपती,मद-पती
युयुजानसप्ती इति युयुजान-सप्ती	युयुजानसप्ती इति युयुजान-सप्ती,युयुजानसप्ती,युयुजान-सप्ती
रुद्रवर्तनी इति रुद्र-वर्तनी	रुद्रवर्तनी इति रुद्र-वर्तनी,रुद्रवर्तनी,रुद्र-वर्तनी
वसुधिती इति वसु-धिती	वसुधिती इति वसु-धिती,वसुधिती,वसु-धिती
वसुमती इति वसु-मती	वसुमती इति वसु-मती,वसुमती,वसु-मती
विचरन्ती इति वि-चरन्ती	विचरन्ती इति वि-चरन्ती,विचरन्ती,वि-चरन्ती
विचर्षणी इति वि-चर्षणी	विचर्षणी इति वि-चर्षणी,विचर्षणी,वि-चर्षणी
वीḻउपाणी इति वीḻउ-पाणी	वीडुपाणी इति वीडु-पाणी,वीडुपाणी,वीडु-पाणी
विवव्री इति वि-वव्री	विवव्री इति वि-वव्री,विवव्री,वि-वव्री
विश्वगूर्ती इति विश्व-गूर्ती	विश्वगूर्ती इति विश्व-गूर्ती,विश्वगूर्ती,विश्व-गूर्ती
विस्फुरन्ती इति वि-स्फुरन्ती	विस्फुरन्ती इति वि-स्फुरन्ती,विस्फुरन्ती,वि-स्फुरन्ती
शँताती इति शम्-ताती	शंताती इति शम्-ताती,शंताती,शम्-ताती
शचीपती इति शची-पती	शचीपती इति शची-पती,शचीपती,शची-पती
सँचरन्ती इति सम्-चरन्ती	संचरन्ती इति सम्-चरन्ती,संचरन्ती,सम्-चरन्ती
सँददी इति सम्-ददी	संददी इति सम्-ददी,संददी,सम्-ददी
सँयती इति सम्-यती	संयती इति सम्-यती,संयती,सम्-यती
सँवयन्ती इति सम्-वयन्ती	संवयन्ती इति सम्-वयन्ती,संवयन्ती,सम्-वयन्ती
सत्पती इति सत्-पती	सत्पती इति सत्-पती,सत्पती,सत्-पती
सधस्तुती इति सध-स्तुती	सधस्तुती इति सध-स्तुती,सधस्तुती,सध-स्तुती
सपत्नी इति स-पत्नी	सपत्नी इति स-पत्नी,सपत्नी,स-पत्नी
समीची इति सम्-ईची	समीची इति सम्-ईची,समीची,सम्-ईची
सयोनी इति स-योनी	सयोनी इति स-योनी,सयोनी,स-योनी
सर्पिरासुती इति सर्पिः-आसुती	सर्पिरासुती इति सर्पिः-आसुती,सर्पिरासुती,सर्पिः-आसुती
सहूती इति स-हूती	सहूती इति स-हूती,सहूती,स-हूती
सिन्धुपती इति सिन्धु-पती	सिन्धुपती इति सिन्धु-पती,सिन्धुपती,सिन्धु-पती
सुजन्मनी इति सु-जन्मनी	सुजन्मनी इति सु-जन्मनी,सुजन्मनी,सु-जन्मनी
सुपत्नी इति सु-पत्नी	सुपत्नी इति सु-पत्नी,सुपत्नी,सु-पत्नी
सुपाणी इति सु-पाणी	सुपाणी इति सु-पाणी,सुपाणी,सु-पाणी
सुप्रतूर्ती इति सु-प्रतूर्ती	सुप्रतूर्ती इति सु-प्रतूर्ती,सुप्रतूर्ती,सु-प्रतूर्ती
सुयवसिनी इति सु-यवसिनी	सुयवसिनी इति सु-यवसिनी,सुयवसिनी,सु-यवसिनी
स्मद्दिष्टी इति स्मत्-दिष्टी	स्मद्दिष्टी इति स्मत्-दिष्टी,स्मद्दिष्टी,स्मत्-दिष्टी
स्वधावरी इति स्वधा-वरी	स्वधावरी इति स्वधा-वरी,स्वधावरी,स्वधा-वरी
स्वर्पती इति स्वः-पती	स्वर्पती इति स्वः-पती,स्वर्पती,स्वः-पती
स्वापी इति सु-आपी	स्वापी इति सु-आपी,स्वापी,सु-आपी
हिरण्यवर्तनी इति हिरण्य-वर्तनी	हिरण्यवर्तनी इति हिरण्य-वर्तनी,हिरण्यवर्तनी,हिरण्य-वर्तनी
अद्भुतक्रतू इत्यद्भुत-क्रतू	अद्भुतक्रतू इति अद्भुत-क्रतू,अद्भुतक्रतू,अद्भुत-क्रतू
अध्रिगू इत्यध्रि-गू	अध्रिगू इति अध्रि-गू,अध्रिगू,अध्रि-गू
अस्मयू इत्यस्म-यू	अस्मयू इति अस्म-यू,अस्मयू,अस्म-यू
अस्मृतध्रू इत्यस्मृत-ध्रू	अस्मृतध्रू इति अस्मृत-ध्रू,अस्मृतध्रू,अस्मृत-ध्रू
ऋतप्सू इत्यृत-प्सू	ऋतप्सू इति ऋत-प्सू,ऋतप्सू,ऋत-प्सू
कृतद्वसू इति कृतत्-वसू	कृतद्वसू इति कृतत्-वसू,कृतद्वसू,कृतत्-वसू
घृतस्नू इति घृत-स्नू	घृतस्नू इति घृत-स्नू,घृतस्नू,घृत-स्नू
जीरदानू इति जीर-दानू	जीरदानू इति जीर-दानू,जीरदानू,जीर-दानू
दुरत्येतू इति दुः-अत्येतू	दुरत्येतू इति दुः-अत्येतू,दुरत्येतू,दुः-अत्येतू
पुनर्वसू इति पुनः-वसू	पुनर्वसू इति पुनः-वसू,पुनर्वसू,पुनः-वसू
पुरुभू इति पुरु-भू	पुरुभू इति पुरु-भू,पुरुभू,पुरु-भू
पुरुमन्तू इति पुरु-मन्तू	पुरुमन्तू इति पुरु-मन्तू,पुरुमन्तू,पुरु-मन्तू
पुरुवसू इति पुरु-वसू	पुरुवसू इति पुरु-वसू,पुरुवसू,पुरु-वसू
पूतबन्धू इति पूत-बन्धू	पूतबन्धू इति पूत-बन्धू,पूतबन्धू,पूत-बन्धू
प्रतद्वसू इति प्रतत्-वसू	प्रतद्वसू इति प्रतत्-वसू,प्रतद्वसू,प्रतत्-वसू
महावसू इति महा-वसू	महावसू इति महा-वसू,महावसू,महा-वसू
वाजिनीवसू इति वाजिनी-वसू	वाजिनीवसू इति वाजिनी-वसू,वाजिनीवसू,वाजिनी-वसू
वज्रबाहू इति वज्र-बाहू	वज्रबाहू इति वज्र-बाहू,वज्रबाहू,वज्र-बाहू
वृधस्नू इति वृध-स्नू	वृधस्नू इति वृध-स्नू,वृधस्नू,वृध-स्नू
वृषण्वसू इति वृषण्-वसू	वृषण्वसू इति वृषण्-वसू,वृषण्वसू,वृषण्-वसू
शचीवसू इति शची-वसू	शचीवसू इति शची-वसू,शचीवसू,शची-वसू
शतक्रतू इति सत-क्रतू	शतक्रतू इति सत-क्रतू,शतक्रतू,सत-क्रतू
शँभू इति शम्-भू	शंभू इति शम्-भू,शंभू,शम्-भू
सबन्धू इति स-बन्धू	सबन्धू इति स-बन्धू,सबन्धू,स-बन्धू
समानबन्धू इति समान-बन्धू	समानबन्धू इति समान-बन्धू,समानबन्धू,समान-बन्धू
सक्रतू इति स-क्रतू	सक्रतू इति स-क्रतू,सक्रतू,स-क्रतू
सुक्रतू इति सु-क्रतू	सुक्रतू इति सु-क्रतू,सुक्रतू,सु-क्रतू
सुदानू इति सु-दानू	सुदानू इति सु-दानू,सुदानू,सु-दानू
सुयवस्यू इति सु-यवस्यू	सुयवस्यू इति सु-यवस्यू,सुयवस्यू,सु-यवस्यू
सृप्रदानू इति सृप्र-दानू	सृप्रदानू इति सृप्र-दानू,सृप्रदानू,सृप्र-दानू
स्मदभीशू इति स्मत्-अभीशू	स्मदभीशू इति स्मत्-अभीशू,स्मदभीशू,स्मत्-अभीशू
अभिस्तुते इत्यभि-स्तुते	अभिस्तुते इति अभि-स्तुते,अभिस्तुते,अभि-स्तुते
अभीवृते इत्यभि-वृते	अभीवृते इति अभि-वृते,अभीवृते,अभि-वृते
आददाथे इत्या-ददाथे	आददाथे इति आ-ददाथे,आददाथे,आ-ददाथे
आमिनाने इत्या-मिनाने	आमिनाने इति आ-मिनाने,आमिनाने,आ-मिनाने
आमेम्याने इत्या-मेम्याने	आमेम्याने इति आ-मेम्याने,आमेम्याने,आ-मेम्याने
इन्द्रेषिते इतीन्द्र-इषिते	इन्द्रेषिते इति इन्द्र-इषिते,इन्द्रेषिते,इन्द्र-इषिते
उपस्तुते इत्युप-स्तुते	उपस्तुते इति उप-स्तुते,उपस्तुते,उप-स्तुते
दूरेअन्ते इति दूरे-अन्ते	दूरेअन्ते इति दूरे-अन्ते,दूरेअन्ते,दूरे-अन्ते
देवपुत्रे इति देव-पुत्रे	देवपुत्रे इति देव-पुत्रे,देवपुत्रे,देव-पुत्रे
देवशिष्टे इति देव-शिष्टे	देवशिष्टे इति देव-शिष्टे,देवशिष्टे,देव-शिष्टे
नियुवैते इति नि-युवैते	नियुवैते इति नि-युवैते,नियुवैते,नि-युवैते
निहिते इति नि-हिते	निहिते इति नि-हिते,निहिते,नि-हिते
न्यृष्टे इति नि-ऋष्टे	न्यृष्टे इति नि-ऋष्टे,न्यृष्टे,नि-ऋष्टे
परिमम्नाथे इति परि-मम्नाथे	परिमम्नाथे इति परि-मम्नाथे,परिमम्नाथे,परि-मम्नाथे
पुरोहिते इति पुरः-हिते	पुरोहिते इति पुरः-हिते,पुरोहिते,पुरः-हिते
पुरुहूते इति पुरु-हूते	पुरुहूते इति पुरु-हूते,पुरुहूते,पुरु-हूते
पूर्वजे इति पूर्व-जे	पूर्वजे इति पूर्व-जे,पूर्वजे,पूर्व-जे
प्रियतमे इति प्रिय-तमे	प्रियतमे इति प्रिय-तमे,प्रियतमे,प्रिय-तमे
भूरिधारे इति भूरि-धारे	भूरिधारे इति भूरि-धारे,भूरिधारे,भूरि-धारे
मधुदुघे इति मधु-दुघे	मधुदुघे इति मधु-दुघे,मधुदुघे,मधु-दुघे
मधुव्रते इति मधु-व्रते	मधुव्रते इति मधु-व्रते,मधुव्रते,मधु-व्रते
विघृते इति वि-घृते	विघृते इति वि-घृते,विघृते,वि-घृते
विभृते इति वि-भृते	विभृते इति वि-भृते,विभृते,वि-भृते
वियुते इति वि-युते	वियुते इति वि-युते,वियुते,वि-युते
विरूपे इति वि-रूपे	विरूपे इति वि-रूपे,विरूपे,वि-रूपे
विश्वजन्ये इति विश्व-जन्ये	विश्वजन्ये इति विश्व-जन्ये,विश्वजन्ये,विश्व-जन्ये
विश्वमिन्वे इति विश्वम्-इन्वे	विश्वमिन्वे इति विश्वम्-इन्वे,विश्वमिन्वे,विश्वम्-इन्वे
विश्ववारे इति विश्व-वारे	विश्ववारे इति विश्व-वारे,विश्ववारे,विश्व-वारे
विषुरूपे इति विषु-रूपे	विषुरूपे इति विषु-रूपे,विषुरूपे,विषु-रूपे
विसिते इति वि-सिते	विसिते इति वि-सिते,विसिते,वि-सिते
विस्कभिते इति वि-स्कभिते	विस्कभिते इति वि-स्कभिते,विस्कभिते,वि-स्कभिते
विह्वयेते इति वि-ह्वयेते	विह्वयेते इति वि-ह्वयेते,विह्वयेते,वि-ह्वयेते
शुचिव्रते इति शुचि-व्रते	शुचिव्रते इति शुचि-व्रते,शुचिव्रते,शुचि-व्रते
सँगच्छमाने इति सम्-गच्छमाने	संगच्छमाने इति सम्-गच्छमाने,संगच्छमाने,सम्-गच्छमाने
सँतस्थाने इति सम्-तस्थाने	संतस्थाने इति सम्-तस्थाने,संतस्थाने,सम्-तस्थाने
सँरराणे इति सम्-रराणे	संरराणे इति सम्-रराणे,संरराणे,सम्-रराणे
सँरिहाणे इति सम्-रिहाणे	संरिहाणे इति सम्-रिहाणे,संरिहाणे,सम्-रिहाणे
सँविदाने इति सम्-विदाने	संविदाने इति सम्-विदाने,संविदाने,सम्-विदाने
सधस्थे इति सध-स्थे	सधस्थे इति सध-स्थे,सधस्थे,सध-स्थे
सनीḻए इति स-नीḻए	सनीडे इति स-नीडे,सनीडे,स-नीडे
सबर्दुघे इति सबः-दुघे	सबर्दुघे इति सबः-दुघे,सबर्दुघे,सबः-दुघे
समन्ते इति सम्-अन्ते	समन्ते इति सम्-अन्ते,समन्ते,सम्-अन्ते
समाराणे इति सम्-आराणे	समाराणे इति सम्-आराणे,समाराणे,सम्-आराणे
समीचीने इति सम्-ईचीने	समीचीने इति सम्-ईचीने,समीचीने,सम्-ईचीने
समृते इति सम्-ऋते	समृते इति सम्-ऋते,समृते,सम्-ऋते
सव्रते इति स-व्रते	सव्रते इति स-व्रते,सव्रते,स-व्रते
सुदिने इति सु-दिने	सुदिने इति सु-दिने,सुदिने,सु-दिने
सुदुघे इति सु-दुघे	सुदुघे इति सु-दुघे,सुदुघे,सु-दुघे
सुदोघे इति सु-दोघे	सुदोघे इति सु-दोघे,सुदोघे,सु-दोघे
सुधृष्टमे इति सु-धृष्टमे	सुधृष्टमे इति सु-धृष्टमे,सुधृष्टमे,सु-धृष्टमे
सुप्रतीके इति सु-प्रतीके	सुप्रतीके इति सु-प्रतीके,सुप्रतीके,सु-प्रतीके
सुभगे इति सु-भगे	सुभगे इति सु-भगे,सुभगे,सु-भगे
सुमिते इति सु-मिते	सुमिते इति सु-मिते,सुमिते,सु-मिते
सुमेके इति सु-मेके	सुमेके इति सु-मेके,सुमेके,सु-मेके
सुरुक्मे इति सु-रुक्मे	सुरुक्मे इति सु-रुक्मे,सुरुक्मे,सु-रुक्मे
सुशिल्पे इति सु-शिल्पे	सुशिल्पे इति सु-शिल्पे,सुशिल्पे,सु-शिल्पे
सुसुम्ने इति सु-सुम्ने	सुसुम्ने इति सु-सुम्ने,सुसुम्ने,सु-सुम्ने
सुस्थाने इति सु-स्थाने	सुस्थाने इति सु-स्थाने,सुस्थाने,सु-स्थाने
स्वर्थे इति सु-अर्थे	स्वर्थे इति सु-अर्थे,स्वर्थे,सु-अर्थे
स्वासस्थे इति सु-आसस्थे	स्वासस्थे इति सु-आसस्थे,स्वासस्थे,सु-आसस्थे
अद्रिसानो इत्यद्रि-सानो	अद्रिसानो इति अद्रि-सानो,अद्रिसानो,अद्रि-सानो
अध्रिगो इत्यध्रि-गो	अध्रिगो इति अध्रि-गो,अध्रिगो,अध्रि-गो
अविहर्यतक्रतो इत्यविहर्यत-क्रतो	अविहर्यतक्रतो इति अविहर्यत-क्रतो,अविहर्यतक्रतो,अविहर्यत-क्रतो
आघृणिवसो इत्याघृणि-वसो	आघृणिवसो इति आघृणि-वसो,आघृणिवसो,आघृणि-वसो
ऋतवसो इत्यृत-वसो	ऋतवसो इति ऋत-वसो,ऋतवसो,ऋत-वसो
कविक्रतो इति कवि-क्रतो	कविक्रतो इति कवि-क्रतो,कविक्रतो,कवि-क्रतो
घृतस्नो इति घृत-स्नो	घृतस्नो इति घृत-स्नो,घृतस्नो,घृत-स्नो
चित्रभानो इति चित्र-भानो	चित्रभानो इति चित्र-भानो,चित्रभानो,चित्र-भानो
जीरदानो इति जीर-दानो	जीरदानो इति जीर-दानो,जीरदानो,जीर-दानो
तुविक्रतो इति तुवि-क्रतो	तुविक्रतो इति तुवि-क्रतो,तुविक्रतो,तुवि-क्रतो
दिवावसो इति दिवा-वसो	दिवावसो इति दिवा-वसो,दिवावसो,दिवा-वसो
दीर्घायो इति दीर्घ-आयो	दीर्घायो इति दीर्घ-आयो,दीर्घायो,दीर्घ-आयो
दुर्हनो इति दुः-हनो	दुर्हनो इति दुः-हनो,दुर्हनो,दुः-हनो
देवयो इति देव-यो	देवयो इति देव-यो,देवयो,देव-यो
धियावसो इति धिया-वसो	धियावसो इति धिया-वसो,धियावसो,धिया-वसो
पुरुक्षो इति पुरु-क्षो	पुरुक्षो इति पुरु-क्षो,पुरुक्षो,पुरु-क्षो
पुरुवसो इति पुरु-वसो	पुरुवसो इति पुरु-वसो,पुरुवसो,पुरु-वसो
पृथुस्तो इति पृथु-स्तो	पृथुस्तो इति पृथु-स्तो,पृथुस्तो,पृथु-स्तो
पृष्टबन्धो इति पृष्ट-बन्धो	पृष्टबन्धो इति पृष्ट-बन्धो,पृष्टबन्धो,पृष्ट-बन्धो
प्रभुवसो इति प्रभु-वसो	प्रभुवसो इति प्रभु-वसो,प्रभुवसो,प्रभु-वसो
प्रयज्यो इति प्र-यज्यो	प्रयज्यो इति प्र-यज्यो,प्रयज्यो,प्र-यज्यो
प्राचामन्यो इति प्राचा-मन्यो	प्राचामन्यो इति प्राचा-मन्यो,प्राचामन्यो,प्राचा-मन्यो
बृहद्भानो इति बृहत्-भानो	बृहद्भानो इति बृहत्-भानो,बृहद्भानो,बृहत्-भानो
भूरिगो इति भूरि-गो	भूरिगो इति भूरि-गो,भूरिगो,भूरि-गो
रदवसो इति रद-वसो	रदवसो इति रद-वसो,रदवसो,रद-वसो
वज्रबाहो इति वज्र-बाहो	वज्रबाहो इति वज्र-बाहो,वज्रबाहो,वज्र-बाहो
वधस्नो इति वध-स्नो	वधस्नो इति वध-स्नो,वधस्नो,वध-स्नो
वरेण्यक्रतो इति वरेण्य-क्रतो	वरेण्यक्रतो इति वरेण्य-क्रतो,वरेण्यक्रतो,वरेण्य-क्रतो
वाजिनीवसो इति वाजिनी-वसो	वाजिनीवसो इति वाजिनी-वसो,वाजिनीवसो,वाजिनी-वसो
विदद्वसो इति विदत्-वसो	विदद्वसो इति विदत्-वसो,विदद्वसो,विदत्-वसो
विभानो इति वि-भानो	विभानो इति वि-भानो,विभानो,वि-भानो
विभावसो इति विभा-वसो	विभावसो इति विभा-वसो,विभावसो,विभा-वसो
विभिन्दो इति वि-भिन्दो	विभिन्दो इति वि-भिन्दो,विभिन्दो,वि-भिन्दो
विश्ववसो इति विश्व-वसो	विश्ववसो इति विश्व-वसो,विश्ववसो,विश्व-वसो
वृषक्रतो इति वृष-क्रतो	वृषक्रतो इति वृष-क्रतो,वृषक्रतो,वृष-क्रतो
शचीवसो इति शची-वसो	शचीवसो इति शची-वसो,शचीवसो,शची-वसो
शाचिगो इति शाचि-गो	शाचिगो इति शाचि-गो,शाचिगो,शाचि-गो
शतक्रतो इति शत-क्रतो	शतक्रतो इति शत-क्रतो,शतक्रतो,शत-क्रतो
सँभृतक्रतो इति सँभृत-क्रतो	संभृतक्रतो इति संभृत-क्रतो,संभृतक्रतो,संभृत-क्रतो
सुक्रतो इति सु-क्रतो	सुक्रतो इति सु-क्रतो,सुक्रतो,सु-क्रतो
सुबन्धो इति सु-बन्धो	सुबन्धो इति सु-बन्धो,सुबन्धो,सु-बन्धो
सुबाहो इति सु-बाहो	सुबाहो इति सु-बाहो,सुबाहो,सु-बाहो
स्वभानो इति स्व-भानो	स्वभानो इति स्व-भानो,स्वभानो,स्व-भानो
अक्षी इवेत्यक्षी-इव	अक्षी इव इति अक्षी-इव,अक्षी इव,अक्षी-इव
आर्त्नी इवेत्यार्त्नी-इव	आर्त्नी इव इति आर्त्नी-इव,आर्त्नी इव,आर्त्नी-इव
उपधी इवेत्युपधी-इव	उपधी इव इति उपधी-इव,उपधी इव,उपधी-इव
चर्मणी इवेति चर्मणी-इव	चर्मणी इव इति चर्मणी-इव,चर्मणी इव,चर्मणी-इव
दँपती इवेति दँपती-इव	दंपती इव इति दंपती-इव,दंपती इव,दंपती-इव
नृपती इवेति नृपती-इव	नृपती इव इति नृपती-इव,नृपती इव,नृपती-इव
प्रधी इवेति प्रधी-इव	प्रधी इव इति प्रधी-इव,प्रधी इव,प्रधी-इव
बृहती इवेति बृहती-इव	बृहती इव इति बृहती-इव,बृहती इव,बृहती-इव
विदुषी इवेति विदुषी-इव	विदुषी इव इति विदुषी-इव,विदुषी इव,विदुषी-इव
विश्पती इवेति विश्पती-इव	विश्पती इव इति विश्पती-इव,विश्पती इव,विश्पती-इव
सप्ती इवेति सप्ती-इव	सप्ती इव इति सप्ती-इव,सप्ती इव,सप्ती-इव
हरी इवेति हरी-इव	हरी इव इति हरी-इव,हरी इव,हरी-इव
शँयू इवेति शँयू-इव	शंयू इव इति शंयू-इव,शंयू इव,शंयू-इव
अश्वे इवेत्यश्वे-इव	अश्वे इव इति अश्वे-इव,अश्वे इव,अश्वे-इव
पदे इवेति पदे-इव	पदे इव इति पदे-इव,पदे इव,पदे-इव
मेने इवेति मेने-इव	मेने इव इति मेने-इव,मेने इव,मेने-इव
यमे इवेति यमे-इव	यमे इव इति यमे-इव,यमे इव,यमे-इव
अकरित्यकः	अकः इति अकः,अकः,अकः
अदरित्यदः	अदः इति अदः,अदः,अदः
अदर्दरित्यदर्दः	अदर्दः इति अदर्दः,अदर्दः,अदर्दः
अभारित्यभाः	अभाः इति अभाः,अभाः,अभाः
अवरित्यवः	अवः इति अवः,अवः,अवः
अस्तरित्यस्तः	अस्तः इति अस्तः,अस्तः,अस्तः
अस्परित्यस्पः	अस्पः इति अस्पः,अस्पः,अस्पः
आवरित्यावः	आवः इति आवः,आवः,आवः
करिति कः	कः इति कः,कः,कः
दर्दरिति दर्दः	दर्दः इति दर्दः,दर्दः,दर्दः
दीधरिति दीधः	दीधः इति दीधः,दीधः,दीधः
भारिति भाः	भाः इति भाः,भाः,भाः
वरिति वः	वः इति वः,वः,वः
वारिति वाः	वाः इति वाः,वाः,वाः
स्परिति स्पः	स्पः इति स्पः,स्पः,स्पः
दर्तरिति दर्तः	दर्तः इति दर्तः,दर्तः,दर्तः
प्रनेतरिति प्र-नेतः	प्रनेतः इति प्र-नेतः,प्रनेतः,प्र-नेतः
विधर्तरिति वि-धर्तः	विधर्तः इति वि-धर्तः,विधर्तः,वि-धर्तः
विधातरिति वि-धातः	विधातः इति वि-धातः,विधातः,वि-धातः
स्वरिति स्वः	स्वः इति स्वः,स्वः,स्वः
ऊवुरित्यूवुः	ऊवुः इति ऊवुः,ऊवुः,ऊवुः
गुरिति गुः	गुः इति गुः,गुः,गुः
तूतोरिति तूतोः	तूतोः इति तूतोः,तूतोः,तूतोः
धुरिति धुः	धुः इति धुः,धुः,धुः
पीपेरिति पीपेः	पीपेः इति पीपेः,पीपेः,पीपेः
मदेरिति मदेः	मदेः इति मदेः,मदेः,मदेः
वनेरिति वनेः	वनेः इति वनेः,वनेः,वनेः
वव्रुरिति वव्रुः	वव्रुः इति वव्रुः,वव्रुः,वव्रुः
वेरिति वेः	वेः इति वेः,वेः,वेः
स्युरिति स्युः	स्युः इति स्युः,स्युः,स्युः
रथ्येभिरिति रथ्येभिः	रथ्येभिः इति रथ्येभिः,रथ्येभिः,रथ्येभिः
प्रचेत इति प्र-चेतः	प्रचेतः इति प्र-चेतः,प्रचेतः,प्र-चेतः
स्त इति स्तः	स्तः इति स्तः,स्तः,स्तः
ग्धेति ग्ध	ग्ध इति ग्ध,ग्ध,ग्ध
त इति ते	त इति ते,त,ते
नमस्यन्निति नमस्यन्	नमस्यन् इति नमस्यन्,नमस्यन्,नमस्यन्
प्रनपाद् इति प्र-नपात्	प्रनपात् इति प्र-नपात्,प्रनपात्,प्र-नपात्
वर्गिति वर्क्	वर्क् इति वर्क्,वर्क्,वर्क्
स्यस्वेति स्यस्व	स्यस्व इति स्यस्व,स्यस्व,स्यस्व
हन्निति हन्	हन् इति हन्,हन्,हन्
अक्षी इति	अक्षी इति,अक्षी
अग्नी इति	अग्नी इति,अग्नी
अचरन्ती इति	अचरन्ती इति,अचरन्ती
अद्री इति	अद्री इति,अद्री
अनूची इति	अनूची इति,अनूची
अन्धसी इति	अन्धसी इति,अन्धसी
अपदी इति	अपदी इति,अपदी
अमिनती इति	अमिनती इति,अमिनती
अमी इति	अमी इति,अमी
अरणी इति	अरणी इति,अरणी
अवन्ती इति	अवन्ती इति,अवन्ती
अवित्री इति	अवित्री इति,अवित्री
असश्चन्ती इति	असश्चन्ती इति,असश्चन्ती
असिन्वती इति	असिन्वती इति,असिन्वती
अहनी इति	अहनी इति,अहनी
आपी इति	आपी इति,आपी
आर्त्नी इति	आर्त्नी इति,आर्त्नी
इन्द्राग्नी इति	इन्द्राग्नी इति,इन्द्राग्नी
इन्द्राबृहस्पती इति	इन्द्राबृहस्पती इति,इन्द्राबृहस्पती
इन्द्राब्रह्मणस्पती इति	इन्द्राब्रह्मणस्पती इति,इन्द्राब्रह्मणस्पती
इषयन्ती इति	इषयन्ती इति,इषयन्ती
उरूची इति	उरूची इति,उरूची
उर्वी इति	उर्वी इति,उर्वी
उशती इति	उशती इति,उशती
ऊती इति	ऊती इति,ऊती
एनी इति	एनी इति,एनी
कवी इति	कवी इति,कवी
कुक्षी इति	कुक्षी इति,कुक्षी
क्रन्दसी इति	क्रन्दसी इति,क्रन्दसी
क्षोणी इति	क्षोणी इति,क्षोणी
गभस्ती इति	गभस्ती इति,गभस्ती
गौरी इति	गौरी इति,गौरी
चर्षणी इति	चर्षणी इति,चर्षणी
जग्मी इति	जग्मी इति,जग्मी
जनसी इति	जनसी इति,जनसी
जनित्री इति	जनित्री इति,जनित्री
जनुषी इति	जनुषी इति,जनुषी
जन्मनी इति	जन्मनी इति,जन्मनी
जर्भरी इति	जर्भरी इति,जर्भरी
जामी इति	जामी इति,जामी
जिव्री इति	जिव्री इति,जिव्री
जुगुर्वणी इति	जुगुर्वणी इति,जुगुर्वणी
ज्ञाती इति	ज्ञाती इति,ज्ञाती
तरन्ती इति	तरन्ती इति,तरन्ती
तुर्फरी इति	तुर्फरी इति,तुर्फरी
दर्वी इति	दर्वी इति,दर्वी
देवी इति	देवी इति,देवी
द्यवी इति	द्यवी इति,द्यवी
द्यावापृथिवी इति	द्यावापृथिवी इति,द्यावापृथिवी
द्यावाभूमी इति	द्यावाभूमी इति,द्यावाभूमी
धामनी इति	धामनी इति,धामनी
धुनी इति	धुनी इति,धुनी
धुनीचुमुरी इति	धुनीचुमुरी इति,धुनीचुमुरी
नदी इति	नदी इति,नदी
नव्यसी इति	नव्यसी इति,नव्यसी
नाधसी इति	नाधसी इति,नाधसी
नारी इति	नारी इति,नारी
नेत्री इति	नेत्री इति,नेत्री
पतत्रिणी इति	पतत्रिणी इति,पतत्रिणी
पती इति	पती इति,पती
पयस्वती इति	पयस्वती इति,पयस्वती
पाजसी इति	पाजसी इति,पाजसी
पाणी इति	पाणी इति,पाणी
पिप्रती इति	पिप्रती इति,पिप्रती
पूर्वी इति	पूर्वी इति,पूर्वी
पृथिवी इति	पृथिवी इति,पृथिवी
पृथ्वी इति	पृथ्वी इति,पृथ्वी
पृषती इति	पृषती इति,पृषती
प्रतीची इति	प्रतीची इति,प्रतीची
प्राची इति	प्राची इति,प्राची
प्लुषी इति	प्लुषी इति,प्लुषी
बप्सती इति	बप्सती इति,बप्सती
बिभ्रती इति	बिभ्रती इति,बिभ्रती
बृहती इति	बृहती इति,बृहती
भवन्ती इति	भवन्ती इति,भवन्ती
भुजी इति	भुजी इति,भुजी
मघोनी इति	मघोनी इति,मघोनी
मदन्ती इति	मदन्ती इति,मदन्ती
महिनी इति	महिनी इति,महिनी
मही इति	मही इति,मही
माकी इति	माकी इति,माकी
माध्वी इति	माध्वी इति,माध्वी
मानवी इति	मानवी इति,मानवी
मायिनी इति	मायिनी इति,मायिनी
मिथती इति	मिथती इति,मिथती
यह्वी इति	यह्वी इति,यह्वी
युवती इति	युवती इति,युवती
रघ्वी इति	रघ्वी इति,रघ्वी
रजसी इति	रजसी इति,रजसी
रजी इति	रजी इति,रजी
राजन्ती इति	राजन्ती इति,राजन्ती
रोदसी इति	रोदसी इति,रोदसी
वक्वरी इति	वक्वरी इति,वक्वरी
वचसी इति	वचसी इति,वचसी
वर्धयन्ती इति	वर्धयन्ती इति,वर्धयन्ती
वह्नी इति	वह्नी इति,वह्नी
वाजयन्ती इति	वाजयन्ती इति,वाजयन्ती
वाणी इति	वाणी इति,वाणी
विश्वामित्रजमदग्नी इति	विश्वामित्रजमदग्नी इति,विश्वामित्रजमदग्नी
वेदी इति	वेदी इति,वेदी
शमीनहुषी इति	शमीनहुषी इति,शमीनहुषी
शुची इति	शुची इति,शुची
सक्षणी इति	सक्षणी इति,सक्षणी
सदस्पती इति	सदस्पती इति,सदस्पती
सद्मनी इति	सद्मनी इति,सद्मनी
सप्ती इति	सप्ती इति,सप्ती
सरसी इति	सरसी इति,सरसी
सस्नी इति	सस्नी इति,सस्नी
सहस्वती इति	सहस्वती इति,सहस्वती
सहुरी इति	सहुरी इति,सहुरी
सानसी इति	सानसी इति,सानसी
सुस्वयन्ती इति	सुस्वयन्ती इति,सुस्वयन्ती
स्रुती इति	स्रुती इति,स्रुती
हरिणी इति	हरिणी इति,हरिणी
हरी इति	हरी इति,हरी
हिरण्ययी इति	हिरण्ययी इति,हिरण्ययी
अजरयू इति	अजरयू इति,अजरयू
अध्वर्यू इति	अध्वर्यू इति,अध्वर्यू
आशू इति	आशू इति,आशू
इन्द्रवायू इति	इन्द्रवायू इति,इन्द्रवायू
इन्द्राविष्णू इति	इन्द्राविष्णू इति,इन्द्राविष्णू
ऊरू इति	ऊरू इति,ऊरू
ऋभू इति	ऋभू इति,ऋभू
कारू इति	कारू इति,कारू
केतू इति	केतू इति,केतू
चमू इति	चमू इति,चमू
चरिष्णू इति	चरिष्णू इति,चरिष्णू
जिगत्नू इति	जिगत्नू इति,जिगत्नू
जेन्यावसू इति	जेन्यावसू इति,जेन्यावसू
तनू इति	तनू इति,तनू
तुर्फरीतू इति	तुर्फरीतू इति,तुर्फरीतू
तुर्वशायदू इति	तुर्वशायदू इति,तुर्वशायदू
धायू इति	धायू इति,धायू
धेनू इति	धेनू इति,धेनू
नृतू इति	नृतू इति,नृतू
पृथू इति	पृथू इति,पृथू
बभ्रू इति	बभ्रू इति,बभ्रू
बाहू इति	बाहू इति,बाहू
भुरण्यू इति	भुरण्यू इति,भुरण्यू
मदेरू इति	मदेरू इति,मदेरू
मनावसू इति	मनावसू इति,मनावसू
मन्दू इति	मन्दू इति,मन्दू
यज्यू इति	यज्यू इति,यज्यू
रघू इति	रघू इति,रघू
वङ्कू इति	वङ्कू इति,वङ्कू
वनर्गू इति	वनर्गू इति,वनर्गू
वल्गू इति	वल्गू इति,वल्गू
वसू इति	वसू इति,वसू
वहतू इति	वहतू इति,वहतू
विपन्यू इति	विपन्यू इति,विपन्यू
विश्पलावसू इति	विश्पलावसू इति,विश्पलावसू
शिशू इति	शिशू इति,शिशू
सनेरू इति	सनेरू इति,सनेरू
सपर्यू इति	सपर्यू इति,सपर्यू
साधू इति	साधू इति,साधू
सूनू इति	सूनू इति,सूनू
सेतू इति	सेतू इति,सेतू
सूर्यावसू इति	सूर्यावसू इति,सूर्यावसू
स्यूमन्यू इति	स्यूमन्यू इति,स्यूमन्यू
हनू इति	हनू इति,हनू
अचक्रे इति	अचक्रे इति,अचक्रे
अजरे इति	अजरे इति,अजरे
अतप्यमाने इति	अतप्यमाने इति,अतप्यमाने
अदब्धे इति	अदब्धे इति,अदब्धे
अन्ये इति	अन्ये इति,अन्ये
अबुध्यमाने इति	अबुध्यमाने इति,अबुध्यमाने
अपारे इति	अपारे इति,अपारे
अमृक्ते इति	अमृक्ते इति,अमृक्ते
अमृते इति	अमृते इति,अमृते
अमृध्रे इति	अमृध्रे इति,अमृध्रे
अर्थयेथे इति	अर्थयेथे इति,अर्थयेथे
अवमे इति	अवमे इति,अवमे
अश्नवैथे इति	अश्नवैथे इति,अश्नवैथे
अस्मे इति	अस्मे इति,अस्मे
आशाते इति	आशाते इति,आशाते
आशाथे इति	आशाथे इति,आशाथे
आस्क्रे इति	आस्क्रे इति,आस्क्रे
इमे इति	इमे इति,इमे
इयाते इति	इयाते इति,इयाते
ईरयेथे इति	ईरयेथे इति,ईरयेथे
ईशाथे इति	ईशाथे इति,ईशाथे
उक्षमाणे इति	उक्षमाणे इति,उक्षमाणे
उक्षिते इति	उक्षिते इति,उक्षिते
उच्येते इति	उच्येते इति,उच्येते
उपाके इति	उपाके इति,उपाके
उभे इति	उभे इति,उभे
ऊह्याथे इति	ऊह्याथे इति,ऊह्याथे
ऋच्यमाने इति	ऋच्यमाने इति,ऋच्यमाने
ऋज्रे इति	ऋज्रे इति,ऋज्रे
ऋधाथे इति	ऋधाथे इति,ऋधाथे
ऋष्वे इति	ऋष्वे इति,ऋष्वे
एते इति	एते इति,एते
एने इति	एने इति,एने
कक्ष्ये इति	कक्ष्ये इति,कक्ष्ये
कृण्वैते इति	कृण्वैते इति,कृण्वैते
कृष्णे इति	कृष्णे इति,कृष्णे
क्रमणे इति	क्रमणे इति,क्रमणे
गभीरे इति	गभीरे इति,गभीरे
गूळ्हे इति	गूळ्हे इति,गूळ्हे
गृणाने इति	गृणाने इति,गृणाने
चक्रमाथे इति	चक्रमाथे इति,चक्रमाथे
चक्राते इति	चक्राते इति,चक्राते
चक्राथे इति	चक्राथे इति,चक्राथे
चक्रे इति	चक्रे इति,चक्रे
चक्षाथे इति	चक्षाथे इति,चक्षाथे
चरेते इति	चरेते इति,चरेते
चिकेथे इति	चिकेथे इति,चिकेथे
जयेथे इति	जयेथे इति,जयेथे
जरेथे इति	जरेथे इति,जरेथे
जवेते इति	जवेते इति,जवेते
जाते इति	जाते इति,जाते
जिहाते इति	जिहाते इति,जिहाते
जोषयेते इति	जोषयेते इति,जोषयेते
ज्येष्ठे इति	ज्येष्ठे इति,ज्येष्ठे
तँसयेथे इति	तँसयेथे इति,तँसयेथे
तन्वाथे इति	तन्वाथे इति,तन्वाथे
तरेते इति	तरेते इति,तरेते
तस्तभाने इति	तस्तभाने इति,तस्तभाने
तुजेते इति	तुजेते इति,तुजेते
तुञ्जाते इति	तुञ्जाते इति,तुञ्जाते
ते इति	ते इति,ते
तोके इति	तोके इति,तोके
त्ये इति	त्ये इति,त्ये
त्रासाथे इति	त्रासाथे इति,त्रासाथे
त्वे इति	त्वे इति,त्वे
दद्वहे इति	दद्वहे इति,दद्वहे
दधाते इति	दधाते इति,दधाते
दधाथे इति	दधाथे इति,दधाथे
दधाने इति	दधाने इति,दधाने
दर्शते इति	दर्शते इति,दर्शते
दिव्ये इति	दिव्ये इति,दिव्ये
दुहाते इति	दुहाते इति,दुहाते
दृँहेथे इति	दृँहेथे इति,दृँहेथे
द्वके इति	द्वके इति,द्वके
द्वे इति	द्वे इति,द्वे
धापयेते इति	धापयेते इति,धापयेते
धारयेथे इति	धारयेथे इति,धारयेथे
धिषणे इति	धिषणे इति,धिषणे
धिष्ण्ये इति	धिष्ण्ये इति,धिष्ण्ये
धेथे इति	धेथे इति,धेथे
धेने इति	धेने इति,धेने
धैथे इति	धैथे इति,धैथे
नमेते इति	नमेते इति,नमेते
नम्नमाने इति	नम्नमाने इति,नम्नमाने
परमे इति	परमे इति,परमे
पवस्ते इति	पवस्ते इति,पवस्ते
पस्पृधाते इति	पस्पृधाते इति,पस्पृधाते
पातल्ये इति	पातल्ये इति,पातल्ये
पावके इति	पावके इति,पावके
पिन्वमाने इति	पिन्वमाने इति,पिन्वमाने
पुनाने इति	पुनाने इति,पुनाने
पृणैथे इति	पृणैथे इति,पृणैथे
प्रत्ने इति	प्रत्ने इति,प्रत्ने
प्रथमे इति	प्रथमे इति,प्रथमे
प्रिये इति	प्रिये इति,प्रिये
बहुले इति	बहुले इति,बहुले
ब्रवैते इति	ब्रवैते इति,ब्रवैते
ब्रुवाते इति	ब्रुवाते इति,ब्रुवाते
भद्रे इति	भद्रे इति,भद्रे
भन्दमाने इति	भन्दमाने इति,भन्दमाने
भयेते इति	भयेते इति,भयेते
भरेते इति	भरेते इति,भरेते
भिक्षमाणे इति	भिक्षमाणे इति,भिक्षमाणे
भियाने इति	भियाने इति,भियाने
भीते इति	भीते इति,भीते
भेजाते इति	भेजाते इति,भेजाते
मनुष्ये इति	मनुष्ये इति,मनुष्ये
ममाते इति	ममाते इति,ममाते
मम्नाते इति	मम्नाते इति,मम्नाते
मात्रे इति	मात्रे इति,मात्रे
मादयेते इति	मादयेते इति,मादयेते
मादयेथे इति	मादयेथे इति,मादयेथे
मादयैते इति	मादयैते इति,मादयैते
माहिने इति	माहिने इति,माहिने
मिमाते इति	मिमाते इति,मिमाते
मिमाने इति	मिमाने इति,मिमाने
मेथेते इति	मेथेते इति,मेथेते
मेने इति	मेने इति,मेने
यजते इति	यजते इति,यजते
यजत्रे इति	यजत्रे इति,यजत्रे
यज्ञिये इति	यज्ञिये इति,यज्ञिये
यतमाने इति	यतमाने इति,यतमाने
यतेते इति	यतेते इति,यतेते
यतैते इति	यतैते इति,यतैते
याजते इति	याजते इति,याजते
युञ्जाथे इति	युञ्जाथे इति,युञ्जाथे
युयुधाते इति	युयुधाते इति,युयुधाते
युवेथे इति	युवेथे इति,युवेथे
युष्मे इति	युष्मे इति,युष्मे
ये इति	ये इति,ये
येमाते इति	येमाते इति,येमाते
योषणे इति	योषणे इति,योषणे
योषे इति	योषे इति,योषे
रक्षेथे इति	रक्षेथे इति,रक्षेथे
रण्विते इति	रण्विते इति,रण्विते
रराथे इति	रराथे इति,रराथे
रिरिचाथे इति	रिरिचाथे इति,रिरिचाथे
रिहाणे इति	रिहाणे इति,रिहाणे
रेजेते इति	रेजेते इति,रेजेते
वदेते इति	वदेते इति,वदेते
वधत्रे इति	वधत्रे इति,वधत्रे
वपुष्ये इति	वपुष्ये इति,वपुष्ये
वरिष्ठे इति	वरिष्ठे इति,वरिष्ठे
वरेथे इति	वरेथे इति,वरेथे
वर्तेते इति	वर्तेते इति,वर्तेते
वर्धेते इति	वर्धेते इति,वर्धेते
ववसाने इति	ववसाने इति,ववसाने
ववृधाते इति	ववृधाते इति,ववृधाते
वसाथे इति	वसाथे इति,वसाथे
वहेथे इति	वहेथे इति,वहेथे
वावशाने इति	वावशाने इति,वावशाने
वितन्तसैते इति	वितन्तसैते इति,वितन्तसैते
विदथे इति	विदथे इति,विदथे
विदाने इति	विदाने इति,विदाने
विश्वे इति	विश्वे इति,विश्वे
वेपेते इति	वेपेते इति,वेपेते
वेविजे इति	वेविजे इति,वेविजे
व्यथेते इति	व्यथेते इति,व्यथेते
शते इति	शते इति,शते
शयाते इति	शयाते इति,शयाते
साशनानशने इति	साशनानशने इति,साशनानशने
शिप्रे इति	शिप्रे इति,शिप्रे
शिवे इति	शिवे इति,शिवे
शीर्षे इति	शीर्षे इति,शीर्षे
शुभ्रे इति	शुभ्रे इति,शुभ्रे
शुम्भमाने इति	शुम्भमाने इति,शुम्भमाने
शूषे इति	शूषे इति,शूषे
शृङ्गे इति	शृङ्गे इति,शृङ्गे
शोभेते इति	शोभेते इति,शोभेते
श्रयेथे इति	श्रयेथे इति,श्रयेथे
सचावहे इति	सचावहे इति,सचावहे
सचेते इति	सचेते इति,सचेते
सचेथे इति	सचेथे इति,सचेथे
सत्यानृते इति	सत्यानृते इति,सत्यानृते
सत्ये इति	सत्ये इति,सत्ये
सदने इति	सदने इति,सदने
सर्स्राते इति	सर्स्राते इति,सर्स्राते
सस्राथे इति	सस्राथे इति,सस्राथे
सस्वजाते इति	सस्वजाते इति,सस्वजाते
सुमेके इति	सुमेके इति,सुमेके
सुवाते इति	सुवाते इति,सुवाते
स्पर्धमाने इति	स्पर्धमाने इति,स्पर्धमाने
स्मयेते इति	स्मयेते इति,स्मयेते
हते इति	हते इति,हते
हवेते इति	हवेते इति,हवेते
हासमाने इति	हासमाने इति,हासमाने
अध्वर्यो इति	अध्वर्यो इति,अध्वर्यो
अशत्रो इति	अशत्रो इति,अशत्रो
इन्दो इति	इन्दो इति,इन्दो
कारो इति	कारो इति,कारो
कृत्नो इति	कृत्नो इति,कृत्नो
गव्यो इति	गव्यो इति,गव्यो
जिष्णो इति	जिष्णो इति,जिष्णो
तपो इति	तपो इति,तपो
दशो इति	दशो इति,दशो
नृतो इति	नृतो इति,नृतो
धृष्णो इति	धृष्णो इति,धृष्णो
पितो इति	पितो इति,पितो
बभ्रो इति	बभ्रो इति,बभ्रो
मधो इति	मधो इति,मधो
मन्यो इति	मन्यो इति,मन्यो
मृत्यो इति	मृत्यो इति,मृत्यो
यहो इति	यहो इति,यहो
वरो इति	वरो इति,वरो
वसो इति	वसो इति,वसो
वायो इति	वायो इति,वायो
विष्णो इति	विष्णो इति,विष्णो
वीळो इति	वीळो इति,वीळो
शिक्षो इति	शिक्षो इति,शिक्षो
सिन्धो इति	सिन्धो इति,सिन्धो
सिष्णो इति	सिष्णो इति,सिष्णो
सूनो इति	सूनो इति,सूनो
स्वादो इति	स्वादो इति,स्वादो
अथो इति	अथो इति,अथो
अपो इति	अपो इति,अपो
अर्यमो इति	अर्यमो इति,अर्यमो
अविष्टो इति	अविष्टो इति,अविष्टो
इमो इति	इमो इति,इमो
इहो इति	इहो इति,इहो
उतो इति	उतो इति,उतो
उपो इति	उपो इति,उपो
एतो इति	एतो इति,एतो
एवो इति	एवो इति,एवो
एषो इति	एषो इति,एषो
ओ इति	ओ इति,ओ
कथो इति	कथो इति,कथो
केनो इति	केनो इति,केनो
क्वो इति	क्वो इति,क्वो
चत्तो इति	चत्तो इति,चत्तो
चो इति	चो इति,चो
जनिष्टो इति	जनिष्टो इति,जनिष्टो
तत्रो इति	तत्रो इति,तत्रो
द्रविणो इति	द्रविणो इति,द्रविणो
नो इति	नो इति,नो
प्रो इति	प्रो इति,प्रो
भूयामो इति	भूयामो इति,भूयामो
मो इति	मो इति,मो
यो इति	यो इति,यो
रक्षो इति	रक्षो इति,रक्षो
वर्धो इति	वर्धो इति,वर्धो
विदो इति	विदो इति,विदो
सप्तो इति	सप्तो इति,सप्तो
सहो इति	सहो इति,सहो
सो इति	सो इति,सो
हन्तो इति	हन्तो इति,हन्तो
अक्षारिति	अक्षाः इति,अक्षाः
अत्सारिति	अत्साः इति,अत्साः
अन्तरिति	अन्तः इति,अन्तः
अजीगरिति	अजीगः इति,अजीगः
अपुनरिति	अपुनः इति,अपुनः
अवरीवरिति	अवरीवः इति,अवरीवः
अवरीवुरिति	अवरीवुः इति,अवरीवुः
अवितरिति	अवितः इति,अवितः
अहरिति	अहः इति,अहः
जरितरिति	जरितः इति,जरितः
दुहितरिति	दुहितः इति,दुहितः
नेतरिति	नेतः इति,नेतः
नेष्टरिति	नेष्टः इति,नेष्टः
पितरिति	पितः इति,पितः
पुनरिति	पुनः इति,पुनः
प्रातरिति	प्रातः इति,प्रातः
भ्रातरिति	भ्रातः इति,भ्रातः
वधरिति	वधः इति,वधः
वरिति	वः इति,वः
सनितरिति	सनितः इति,सनितः
सनुतरिति	सनुतः इति,सनुतः
सवितरिति	सवितः इति,सवितः
सस्वरिति	सस्वः इति,सस्वः
होतरिति	होतः इति,होतः
ईमिति	ईम् इति,ईम्
ऊँ इति	ऊँ इति,ऊँ